{
    "level1": {

        
            "no_of_rows":7,
            "stucture":[

                1,1,1,1,1,
                1,0,0,0,1,
                1,0,0,0,1,
                1,1,0,1,1,
                1,0,0,0,1,
                1,1,0,1,1,
                1,1,1,1,1
            ]

    }
        
}